7 7 1
. . * . . . *
. . . . . * .
. . . . . . *
. . . * . . .
. * . . * . .
. . . . . . .
* . . * . . .
